#########################
#S#   #                 #
# # # # ######### ##### #
#   # # #         # #   #
##### ### ######### # ###
#   #   #   #         # #
# # ### # # ######### # #
# #   # # # #       # # #
# ### # # # # ##### # # #
# # # # # #   #     # # #
# # # # ####### ##### # #
#   # #         #   #   #
### # ############# ### #
# # #       #         # #
# # # ### ### # ####### #
#   #   # #   #         #
# ##### ### #############
# #   #     # #         #
# ### ####### # ### ### #
#       #     #   #   # #
####### # # ### ##### ###
#     # # #     #   #   #
# ##### ######### # ### #
#                 #    E#
#########################